"a" = (/tile/grass,/area)
"b" = (/tile/dirt,/area)

(1,1,1) = {"
abbbbabbbb
abbbbabbbb
aabbaaabba
aabbaaabba
aabbaaabba
aaaaaaabba
aabbbbbbba
aabbbbbbba
aabbbbbbba
aaaaaaaaaa
"}
